25 25 25 25 25 25 25 25 25 25 25 25 25 25 25 25 25 25 25 25 25 25 25 25 25 25 25 25 25 25 25 25 25 25 25 25 25 26 26 26 26 26 26 26 26 26 26 26 26 26
0 0 0 0 25 25 25 25 25 25 25 25 25 25 25 0 0 0 0 0 0 0 0 0 0 0 0 0 0 0 0 0 0 0 0 0 0 26 26 0 2 2 2 4 2 2 4 2 2 26
0 0 0 25 25 0 20 20 20 20 20 20 20 20 20 20 20 0 0 0 0 0 0 0 0 0 27 27 27 27 27 27 27 0 0 0 0 26 26 0 2 2 2 2 2 2 2 2 20 26
0 0 0 25 20 20 20 25 25 25 25 25 25 25 25 0 20 20 20 0 0 2 0 0 25 0 27 15 15 15 15 15 27 0 0 0 0 26 26 26 0 0 2 2 2 2 2 20 20 26
0 0 0 25 20 25 25 25 0 0 0 0 0 0 25 25 0 0 20 0 0 0 0 0 25 0 27 15 15 15 15 15 27 0 0 0 1 26 26 26 26 0 2 2 4 2 2 20 2 26
3 0 0 25 20 25 25 0 0 0 0 0 0 0 1 25 25 0 20 0 0 0 0 0 25 0 27 15 15 15 15 15 27 0 0 0 0 0 0 26 26 26 2 2 2 2 20 20 2 26
3 0 0 25 20 25 0 2 0 0 0 0 0 0 0 0 25 25 20 0 0 0 0 0 25 0 27 15 15 15 15 15 27 0 0 0 0 0 0 26 26 26 2 2 2 20 20 2 2 26
3 0 0 25 20 25 0 0 0 0 1 0 1 0 0 0 0 25 20 0 0 0 0 0 25 0 27 15 15 15 15 15 27 20 0 0 0 0 0 0 26 26 26 2 2 20 0 0 2 26
3 0 0 25 20 25 0 0 0 0 0 0 0 1 0 0 0 25 20 0 0 0 0 0 25 0 27 15 15 15 15 15 27 20 0 0 0 0 0 1 26 26 26 2 2 20 2 2 2 26
3 0 0 25 20 0 0 0 0 0 6 7 7 7 8 0 0 25 20 20 0 0 0 0 25 20 15 15 15 15 15 15 15 20 0 0 0 0 0 0 0 26 26 26 20 20 2 0 26 26
25 25 25 25 20 0 0 0 0 0 9 10 10 10 11 0 0 25 0 20 0 0 0 25 25 20 0 0 0 0 0 0 0 20 20 0 0 0 0 0 0 26 26 0 20 0 0 0 26 26
25 25 0 20 20 0 0 0 0 0 9 10 10 10 11 0 0 25 0 20 0 0 25 25 0 20 0 0 0 0 0 0 0 0 20 0 0 26 0 0 0 26 26 0 20 0 0 0 26 26
25 0 20 20 0 0 1 0 0 0 9 10 10 10 11 0 25 25 0 20 0 0 25 0 0 20 0 0 0 0 0 0 0 0 20 0 0 26 26 0 0 0 26 0 20 0 0 0 26 26
25 0 20 0 0 0 0 0 0 0 9 10 10 10 11 0 25 0 20 20 0 25 25 0 0 20 0 0 0 0 0 0 0 0 20 0 0 0 26 0 0 26 0 0 20 0 0 0 26 26
25 25 20 0 0 0 0 0 0 0 9 10 10 10 11 25 25 0 20 0 0 25 0 0 20 20 0 0 0 0 0 0 0 0 20 20 0 26 26 0 0 26 0 0 20 0 0 0 26 26
25 25 20 0 0 0 2 0 0 0 12 13 13 13 14 25 0 20 20 0 0 25 0 0 20 0 0 26 0 0 0 0 0 0 0 20 0 26 0 0 0 26 0 0 20 0 0 0 26 26
25 25 20 0 0 0 0 0 0 0 0 25 25 25 25 25 20 20 0 0 0 25 0 20 20 0 0 26 0 0 0 0 0 0 0 20 0 26 0 1 0 26 0 20 20 0 0 26 26 26
3 25 20 0 0 0 0 0 0 25 25 25 0 0 20 20 20 0 0 0 25 0 0 20 0 0 26 26 0 2 0 20 20 20 20 20 0 26 0 0 26 26 0 20 0 0 0 26 0 26
25 25 20 20 0 0 0 1 0 25 0 20 20 20 20 0 0 0 0 25 25 0 0 20 0 0 26 0 0 0 0 20 0 0 0 0 0 26 26 26 26 0 20 20 0 0 26 26 0 26
25 25 0 20 0 25 25 25 25 0 20 20 0 0 0 0 0 0 0 0 0 20 20 20 0 26 0 0 0 0 0 20 20 0 0 0 0 0 0 0 0 20 20 0 0 0 0 0 0 26
25 0 0 20 0 25 0 0 0 0 20 0 0 0 0 0 0 0 0 0 20 20 0 0 26 26 0 0 0 0 0 0 20 20 0 0 0 0 0 20 20 20 26 26 26 26 0 0 1 26
25 0 0 20 0 25 0 0 0 0 20 20 20 0 0 0 0 0 20 20 0 0 0 0 26 0 0 0 0 0 0 0 0 20 20 20 20 20 20 20 0 0 0 0 0 0 26 26 26 26
25 0 20 20 0 25 0 0 0 0 0 0 20 20 20 20 20 20 20 0 0 0 0 26 26 0 0 0 0 0 0 0 0 0 0 0 0 0 0 0 0 0 0 0 0 0 0 0 0 26
25 0 20 0 25 25 0 0 0 0 0 0 0 0 0 0 0 0 0 0 0 0 26 26 0 0 0 0 0 0 0 0 0 0 25 25 25 25 25 25 25 25 25 25 25 0 0 0 0 26
25 0 20 0 25 0 0 0 0 0 0 0 0 0 0 0 0 0 0 0 0 0 0 0 0 0 0 0 0 0 0 0 0 0 25 20 20 20 20 20 20 20 20 20 25 25 0 0 0 26
25 0 20 0 25 0 0 25 25 25 25 25 25 25 25 25 25 25 25 0 0 0 0 0 0 0 0 0 0 0 0 0 25 25 25 20 0 0 0 0 0 0 0 20 20 25 0 0 0 25
25 0 20 0 25 0 0 25 0 28 28 28 28 28 28 28 28 20 0 25 0 0 0 0 0 0 0 0 0 0 0 25 25 0 20 20 0 0 0 0 0 0 0 0 20 25 25 0 0 25
25 0 20 0 25 0 25 25 0 28 15 15 15 15 15 15 28 20 20 0 25 0 0 0 0 2 0 0 0 25 25 0 0 20 20 0 0 0 0 0 0 0 0 0 20 20 25 0 25 25
25 0 20 0 25 25 25 0 20 15 15 15 15 15 15 15 15 20 20 0 25 25 0 0 0 0 0 25 25 25 0 0 20 20 0 0 0 0 3 3 3 3 3 3 0 20 25 25 25 25
25 0 20 0 0 0 0 20 20 15 15 15 15 15 15 15 15 20 20 20 0 0 25 25 0 0 0 25 0 0 0 0 20 0 0 0 0 3 3 0 0 0 0 3 0 20 20 25 25 25
25 0 20 0 0 0 20 20 0 28 15 15 15 15 15 15 28 28 0 20 0 0 0 25 25 25 25 25 0 0 0 20 20 0 0 0 0 3 0 0 0 0 0 3 0 0 20 25 25 25
25 0 20 20 0 20 20 0 0 28 28 15 15 15 15 28 28 0 0 20 20 0 0 0 0 25 25 0 0 0 0 20 0 0 0 0 3 3 3 0 0 0 0 3 0 0 20 25 25 25
25 0 0 20 20 20 0 0 0 0 28 28 28 28 28 28 0 0 0 0 20 20 0 0 0 0 0 0 0 0 20 20 0 0 0 3 3 0 0 0 0 2 0 3 3 0 20 25 25 25
25 25 0 0 0 0 0 0 0 0 0 0 0 0 0 2 0 0 0 0 0 20 20 0 0 0 0 0 20 20 20 0 0 0 0 3 0 0 0 0 0 0 0 0 3 0 20 25 25 25
25 25 25 25 0 0 0 0 1 0 0 3 3 3 3 0 0 0 0 0 0 0 20 20 20 20 20 20 20 0 0 0 3 3 3 0 0 0 0 0 0 0 0 0 3 0 20 25 25 25
25 0 0 0 0 0 0 3 3 3 3 3 3 3 3 3 3 0 0 0 0 0 0 0 0 0 0 0 0 0 0 3 3 0 0 0 0 0 0 0 0 0 0 0 3 0 20 25 25 25
25 0 0 0 3 3 3 3 3 3 3 3 3 0 0 0 3 3 0 0 0 0 0 0 0 0 0 0 0 0 3 3 0 0 0 0 0 0 0 0 0 0 0 3 3 0 20 25 25 25
25 3 3 3 3 3 3 3 3 25 25 25 25 25 0 0 0 0 3 0 0 0 0 0 0 0 0 0 0 0 3 0 0 0 0 0 0 0 0 0 0 0 0 3 0 0 20 25 25 25
25 3 3 3 3 0 0 0 20 20 20 20 20 25 25 0 0 0 3 3 0 1 0 0 0 0 0 0 0 3 0 0 0 0 0 0 0 0 0 0 0 3 3 3 0 20 20 25 25 25
25 3 3 0 0 0 0 0 20 20 25 25 20 20 25 0 0 0 0 3 3 3 3 3 3 3 3 3 3 3 0 0 0 0 0 0 0 0 0 3 3 3 0 0 0 20 25 25 25 25
25 3 1 0 0 0 0 0 20 20 26 25 25 20 25 0 0 1 0 0 0 0 0 3 3 3 3 3 3 3 0 0 0 3 3 3 3 3 3 3 0 0 0 0 0 20 25 25 25 25
25 0 0 0 0 0 2 0 20 20 25 25 25 20 25 0 0 0 0 0 0 0 0 0 0 0 3 3 3 3 3 3 3 3 0 0 0 0 0 0 0 20 20 20 20 20 25 25 25 25
25 25 25 25 0 0 0 0 20 20 25 25 25 20 25 0 0 0 0 1 0 0 0 0 0 0 0 3 3 3 0 0 0 0 0 0 0 0 0 20 20 20 26 26 26 26 25 25 25 25
25 0 0 25 25 0 1 0 20 20 25 25 25 20 25 0 0 0 0 0 0 0 0 0 0 0 20 20 20 20 20 20 20 20 20 20 20 20 20 20 26 26 26 26 26 26 26 26 25 25
25 0 0 0 25 26 0 0 20 20 25 25 25 20 20 0 0 0 0 0 0 0 0 0 20 20 20 25 25 25 25 25 25 25 25 25 25 25 25 25 25 26 26 26 26 26 26 25 25 25
25 0 0 0 25 25 25 25 20 20 25 25 25 25 20 0 0 0 0 0 20 20 20 20 20 25 25 25 25 25 25 25 25 25 25 25 25 25 25 25 25 25 25 25 25 25 25 25 25 25
25 20 20 20 20 20 20 20 20 20 25 25 25 25 20 0 0 0 0 20 20 25 25 25 25 25 25 25 25 25 25 25 25 25 25 25 25 26 25 25 25 25 25 25 26 25 25 25 25 25
25 20 20 20 20 20 20 20 20 20 25 25 25 25 20 20 20 20 20 20 25 25 25 25 25 25 25 25 25 26 25 25 25 26 25 25 25 25 25 25 25 25 25 25 25 25 25 25 25 25
25 20 20 20 20 20 20 20 20 20 25 25 26 25 25 25 25 25 25 25 25 25 25 25 25 25 25 25 25 25 25 25 25 26 25 25 25 26 25 25 25 25 25 25 25 25 25 25 25 25
25 25 25 25 25 26 25 25 25 25 25 25 25 25 25 25 25 25 25 25 25 25 25 25 25 25 26 25 25 25 25 25 25 25 25 25 25 25 25 25 25 25 25 25 25 25 26 25 25 25
